111111111111111
1E0C1000C0000C1
100000C0000P001
111111111111111
100000000000001
100000000000001
100000000000001
111111111111111