1111111111111
1111CCCCCCCC1
11CCC111111C1
1PCE110CCCCC1
1111111111111