11111111111111
100E0000C000P1
1000001000C001
11111111111111